+------------------+
|      |           |
|--- + |  ------+  |
|    |          |  |
| +  +------+   |  |
| |         |   |  |
| +----+----+---+  |
|      |           |
|---+  +-----------|
|   |             O|
|---+              |
+------------------+
