+------------------+
|      |           |
|--- + |  ------+  |
|               |  |
| +  +------+   |  |
| |         |   |  |
| +----+----+---+  |
|      |           |
|---+  +-----------|
|   |             O|
|---+              |
+------------------+
